q----------w
/..........\
/________..\
/..........\
/___...____\
/..........\
/_.._______\
/..........\
/_______...\
/.@.*......\
e__________r
